########################################
#..#.h.#.......c....4....c.....b.bbbbbb#
#..#...c.......c####5....c#....#.#######
#.b####c.......cc...6....c#......c.....#
#......c.#.....#c.....X.bc#.....1c...#.#
#......c.c.#....c....######.....2###.c.#
#1######4c.c....c.....c.........3...1c.#
#2......5c.c#####....#c.............2c.#
#3X.....6c.c.........#c.X...........3c.#
----------------------------------------