########################################
#........X.............c...........X.c.#
#.......###........####c.......c#####c.#
#..................#...c.....b.c.....c.#
#..h#.............##...c....###c.....c.#
#.b.c............bc#...c.............c.#
#4##c.........1###c#...c###4.........c.#
#5..c.........2...c....c...5.........c.#
#6..c..b..X...3...c....c...6.........c.#
########################################