########################################
#..#.h.#.......c...b4...c......b.bbbbbb#
#..#...c.......c####5...c#.....#.#######
#.b####c.......cc...6.X.c#.......c.....#
#......c.#.....#c....#####......1c...#.#
#......c.c.#....c....#..........2###.c.#
#1######4c.c....c....#..........3...1c.#
#2......5c.c#####....#..............2c.#
#3X.....6c.c.........#..X...........3c.#
----------------------------------------