########################################
#..#.h.#.......c...b4....#.......bbbbbb#
#..#...c.......c####5....#.......#######
#.b####c.......cc...6.X.b#.......c.....#
#......c.#.....#c....#####......1c...#.#
#......c.c.#....c...............2###.c.#
#1######4c.c....c...............3...1c.#
#2......5c.c#####...................2c.#
#3X..X..6c.c............X...........3c.#
----------------------------------------